.................................................#....................................................
..........................................!......#....................................................
..........................................#......#....................................................
...............................#.................#....................................................
.................................................#....................................................
.............................................!............................!!..........................
.............................................#...|........................###.........................
.........................../.........!...........#...................###..............................
..................!........#........!#!..........#..............###................!....####..........
..................#........+.......!#.#!.........#.........###!!!....!.........!...+....++++....!.....

